|||||||||
|.......|
|##||||||
|#|...|.|
|...|...|
||||||+||
|.......|
|..||||||
||......|
|||||||||