||||||||||||||||||||||||||||||||||||||||||||||||||||||||||||
|.....||||||.......||....+#|........+################+||||||
|.....+####+........|....|#|........|||#|||||||||||||......|
|.....||#|||...||...+....|#|||+||||||||#||.................|
||||||||+||||||||||||....|#|.....||||||+||......||||.....|||
||||.........|||####+....|#|.....|.......||||.........||||||
|||..........|||+|||||||||#+.....|...||..|.....||||....||..|
|............|||......||||||||||+|.......|.................|
|+||||||||||||||......||||||......|||+||||..............||||
|#|.....|.....|||.....||||||......|......|......|||||...||||
|#|.....|.....|||||#|||||||.......|......|....|||||||...||||
|#|.....+....+|||||#|.....|||||||+||.....|........||||||||||
|#||+||||||||...|||#||....|........|||||||.............|||||
|####||||.......+####+....|........|||||||..............||||
||||||||||||||||||||||||||||||||||||||||||||||||||||||||||||