||||||||||
|........|
|###||||||
|##|...|.|
|....|...|
||||||+|||
|........|
|...||||||
||.......|
||||||||||